1111111111111111111111111111111111
1E0000000000000C1000C1000000000001
1000010000000000101001000000000001
1000010000000000101001000000011111
1P0000000C00C0000010000000000000C1
1111111111111111111111111111111111
