11111111111111111111111
1C00000000000000C000001
10000000000000000000001
1111111111111100C000001
1E000000000001000000001
1111111110111100P000001
1C000000000001000000001
10000000000001000000001
10011110001111000000001
10000000000C000000C0001
11111111111111111111111
