11111111
100000C1
1C001101
11111001
10000001
10000001
10000001
100000C1
1EP00001
10000001
1C000001
10000001
10000001
10000001
10000001
10000001
10000001
10000001
10000001
1C000001
10000001
10000001
10000001
10000001
11111111
