11111111111111111111111111111111
1PCCCCCCCCCCCCCCCCCCCCCCCCCCCCE1
11111111111111111111111111111111
