1111111111
1P000000E1
1110111101
1C000010C1
1000000001
1111111111

