111111111111
1P000000001E1
1011110111101
1C000000000C1
111111111111

