111111111
1P00000E1
101110101
1C00000C1
111111111

