111111111111
1P000000000E1
1110111011101
1C000000000C1
111111111111

