111111111111
1P0000C0000E1
1011110111101
1C000000000C1
111111111111

