11111111111111
1C0000000000E1
10000000P00001
11111111111101
1E000000000001
11111111111111
