11111111111111
1C000000000001
10000000P00001
11111111111111
1E000000000001
11111111111111
