11111111111111
1C000001000001
10000001P00001
11111111111101
1E000000000001
11111111111111
